NO ./textures/Nature/Rocks.xpm
SO ./textures/Nature/Wood.xpm
WE ./textures/Nature/Tree.xpm
EA ./textures/Nature/Hedge2.xpm
C 153,153,255
F 155,209,74


1111111
111111111                       111111111
11111111111111111111111111111111111111111
10000000000000000000000000001000001
11111000000000000000000111110000011
11100000000000000000000000001000001
10000000000001001110011111111000011
100000000000010000000000000010000N1
11111100000001000000000000001000001
10000100000001000000000000001000011
10000100000001000000000000001000001
10000011100001000000000000001000011
11000000000001000000000000001000001
11111100000000000000000000001000011
10000000000000000000000000001000001
10011111111111111111111111111111111111111
1111