NO textures/Basic/north.xpm
SO textures/Basic/south.xpm
WE textures/Basic/east.xpm
EA textures/Basic/east.xpm
C 83,77,205
F 155,113,71

11111111111111111111111111111
10000000001100000000000000001
10000000001000101001000100011
10000000001100100000000010001
100000000011E0000001000010001
10000000001100000111011110001
11111111111111011100000010001
11111111111111111111111111111