NO ./textures/Nature/Rocks.xpm
SO ./textures/Nature/Wood.xpm
WE ./textures/Nature/Tree.xpm
EA ./textures/Nature/Hedge2.xpm
C 153,153,255
F 155,209,74

1111111111111111
1010101000010001
1001010000011001
1000000000000001
1000000000000001
1111111110111111
1000000000000001
1000000000000001
1000000000000001
1000000000000001
1000000000000001
1000000000000001
1100000000S00011
111111111111111111