NO ./textures/Nature/Rocks.xpm
SO ./textures/Nature/Wood.xpm
WE ./textures/Nature/Tree.xpm
EA ./textures/Nature/Hedge2.xpm
C 153,153,255
F 155,209,74

11111
10001
10001
10001
100S1
10001
10001
10001
10001
111111111