NO ./textures/Test/big2.xpm
SO ./textures/512x512/test4.xpm
WE ./textures/512x512/test10.xpm
EA ./textures/Test/big.xpm
C 153,153,255
F 95,211,199

11111
10001
10001
10001
100S1
10001
10001
10001
10001
111111111